11111111
00000000
11100000
11100000
00000000
00000000
00000011
11111111
