00111111
00000001
11011001
11011001
11000001
11100001
00000000
11111111
