11111111
00000001
11111011
00011000
00000000
01111100
00000100
11110111
