00000000
00101100
00100000
00110000
00000000
00001100
00001100
11111111
