11100000
11111100
11100000
11100001
00000001
11100011
11100011
11100111
